Abandon - napustiti, razuzdanost, raskalašnost
Abreast - uporedo, u toku, jedan pored drugog
Accost - prići, osloviti
Adorn - ukrasiti, ulepšati, dičiti se
Adroitly - spretno
Aghast - zgrožen, užasnut, zbunjen, prestravljen
Appropriate - prikladan, zgodan, odrediti, prisvojiti, opredeliti
Arbor - vreteno, osovina, senica, hladnjak
Avarice - srebroljublje, škrtost, pohlepa
Barbican - spoljni zid tvrđave, dupla kula na kapiji tvrđave
Battlements - zidine
Bay - zaliv, dorat, lovor, isturen prozor, tesnac, goniti, terati, lajati
Befoul - ukaljati
Bile - žuč
Bitter - gorak, ogorčen, žestok, ljut
Bluff - blef, obmana, zavarati, neotesan, strm
Brass - mesing
Calvary - mučeništvo, raspeće, stradanje
Cavort - vitality, skakati tamo-amo
Caw - gakati, gakanje
Chackle - cerekanje
Clamor - galama, vika, buka, krik, vikati, galamiti
Cling - prilepiti, držati se, prianjati
Club - klub, društvo, batina, tref, pendrek, štap za golf, toljaga, izbatinati
Conven - sazvati, sastati se, skupiti se
Courser - brz konj
Cram - strpati, nabiti, natrpati, nakljukati, nagruvati
Crude - sirov, grub, neobrađen, banalan
Dart - strelica, liznuti, palacati, baciti, vrzmati se, ustremiti
Desolation - pustoš, opustošiti
Dexterous - spretan, vešt
Disconcerting - zbunjujuće, uznemirujuće
Distress - opasnost, tuga, nevolja, žalost
Dodging - izmicanje
Doom - propast, sudbina, zla kob, strašni sud, osuditi na propast
Dreading- strahujući
Drum - bubanj, rezervoar, valjak, bubnjati
Enamel - emajl,, gleđ 
Etched - urezano, ugravirano
Exclaim - uzviknuti iznenada (od bola, iznenađenja, besa)
Falter - pokolebati se, posrnuti
Fishmonger - ribar, trgovac ribom
Flip - naglo se okrenuti, napraviti nagli pokret
Folly - ludost
Forswore - prekršiti zakletvu
Foul - gadan, zapušten, pogrdan, prljav, smrdljiv, nepošteno, prljavo, zamrsiti, prekršiti, uprljati, prekršaj
Fowl - живина, loviti divljač
Freckle - pega
Fringe - resa, krilo, granica, ivica, šiške na čelu
Fumble - petljati, napipavati, preturati, nespretno rukovati, mumlati
Furl - saviti, slagati
Furnish - snadbeti, namestiti
Gale - bura, razdraganost, jak vetar
Garnet - granat (crveni dragi kamen)
Glower - gledati smrknuto, mrgođenje
Granary - žitnica, ambar
Gravel - šljunak, tucanik
Grievous - tužan, bolan
Grip - stisak, drška, uhvatiti, privući pažnju, obuzeti, rukovanje
Grotesque - deforimasn, čudan, monstruozan, neprirodan, 
Guffaw - vriskati, vriskanje
Gust - nalet
Haggle - cenkati se
Haste - žurba
Hastily - užurbano, zbrda-zdola, naprasito, letimice
Hay - seno
Headsman - starešina
Heave - ispustiti, baciti, dići
Heaving - dizanje, uzdah, izdizanje, podizanje
Heft - odmeravati, tegliti, glavna stvar, teret, podizanje
Hew - seći, klesati
Hive - košnica, prihvatiti
Howl - urlati 
Hull - trup, sanduk, magacin, ljuska, otrebiti, oljuštiti
Hurl - baciti, obasuti
Immense - ogroman, neizmeran, nenadmašan
Impale - nabijati na kolace, nabijati
Impersonation - lažno predstavljanje, igranje uloge, predstavljanje
Inching - kretati se polako u nekom pravcu
Incredulously - nepoverljivo, neverno
Insistent - uporan
Intricate - složen, zapetljan, zamršen
Jackanapes - uobraženko, majmun
Jape - šega, lakrdija, ruganje
Jibe - podsmeh, slagati se, okretati jedro
Kernel - zrno, jezgro
Kin - rođaci, rodbina
Knitting - pletenje, štrikanje
Lair - jazbina, stanište
Lame - hrom, šepav, neubedljiv, osakatiti
Lapping - srkati, zapljuskivati, preklopiti, prestići za ceo krug 
Lash - trepavia, bič, oštra primedba, udarac (bičem), vezati, išibati, napasti
Lazing - lenčarenje, dangubljenje
Lead - dovesti, voditi, navesti, povodac, olovo, mina, grafitni
Lest - da ne bi
Liable - odgovoran, obavezan, podložan
Linen - posteljina, platno, lan, rublje, laneni, u boji platna
Loath - mrzeti, gaditi se, gnušati se
Lope - dugačak korak, ravnomeran hod
Lunge - zadati udarac vrhom mača, baciti se, nago pokret, trzaj
Mangle - pokvariti, valjati rublje
Mead - medovina, livada
Merlings - riba, mitsko biće pola čovek pola riba
Niggardly - mrsko, škrto, stegnuto, cicijaški, tvrd, škrt
Nonplussed - zbunjen
Oar - veslo, mešalica za pivo, noga sa opnom između prstiju
Obscenity - odvratnosi, razvratnost, sramnost
Pelt - krzno, koža, baciti na, obasipati
Perched - metnuti, natakariti, nataći, spustiti se
Pile - gomila, hrpa, naslaga, stub, vlas, dlaka, imetak, kolac, malja, nagomilati, naslagati, podupirati, pretrpati, složiti
Pincers - klešta, pinceta, hvataljka
Pinion - zupčanik, krilo
Plead - moliti, braniti pred sudom, iznositi dokaze
Plunge - gnjuranje, uroniti, strmoglaviti, skočiti, zariti
Ply - slagati(složiti), struk, sloj, saobraćati, častiti, saletati, spojiti
Pockmarked - rošav
Pommel - jabuka na sedlu, oglavlje
Ponderous - težak, masivan
Pounding - lupanje, bombardovanje
Prance - šepuriti se, propinjati se
Prancing - propinjući
Prodigious - čudesan, torostasan
Prudent - razborit, pametan, obazriv
Pummeling - udaranje, premlatiti
Quay - kej
Quell - ugušiti, zaustaviti, ukrotiti
Rack - lupati, moriti, mučiti, razbijati, raf, police, postolje uništenje
Rail - šina, prečaga, grditi, psovati
Ram - ovan, kljun, dokazati, nabiti, udariti, probiti
Ramshackle - trošan, oronuo
Rankle - gristi, mučiti, gnojiti se
Redoubt - privereno utvrđenje, reduta
Relic - ostatak, relikvija
Relics - ostaci, mošti
Retch - povraćanje, gađenje, zgaditi se
Rigging - sistem konopaca za jedro na brodu, montaža, lažiranje
Rower - veslač
Ruddy - rumen, đavolski, crven
Scarves - šal, marama, spoj
Scourge - bič, kazna, bičevati, kazniti, opustošiti, opljačkati
Shack - koliba, baraka, ćumez, probisvet
Skim - brzo pregledati, kliziti, obrati, praviti žabice, skinuti, pena, skrama
Slanders - keleveta, ogovaranje
Sling - praćka, remenik, omča, baciti, obesiti, visiti
Slipping - klizeći
Sloop - slup/vrsta broda
Slump - padati, opasti, srozati se, recesija
Slung - bačen, obešen, (koji je visio)
Sly - lukav, skriven, prepreden
Smoldering - tinjajući
Soak - potopiti, upiti, natopiti, obliti, prevše naplatiti, preceniti
Soar - jedriti, vinuti se
Spotted - uočen, pegav, šaren, umrljan
Spray - poprskati, zaprašiti, nakit u obliku biljke
Sprouting - nicanje, izbijati, nicati
Squat - čučnuti, čučanj, zdepast, naseliti se bez dozvole
Stagger - teturati, gegati, vrdati, poljuljati, zaprepastiti
Stem - stabljika, drška, osnova, repić, cev, loza, struk, stabljika, zadržavati, zaustaviti, poticati
Stiff - ukočen, krut, gust, strog, jak, leš, čovek, pijanica
Stifle - ugušiti, gušiti, daviti
Stir - komešanje, mešati, žariti, zamutiti, micati se, podstaći, uzbuditi, uzbuna, gužva, zatvor
Strap - kaiš, remen, privezati kaišem, tući kaišem
Strip - strip, pruga, traka, skinuti, rasklopiti, guliti, lišiti, očerupati
Stubby - tvrdoglav, zdepast, panjevit, čekinjaav
Stud - pastuv, dugme, gvožđe, direk, klin, okovati
Studded - okovan klincima
Sunken - utonuo, ukopan, ispijen
Swath - otkos
Tar - katran, premazati katranom
Taut - zategnuti, zategnut, nategnut, uredan
Thrust - potisak, udar, ubod, guranje, napad, tendencija, 
Tittrers - cerekati se, kikotati
Token - znak, simbol, žeton, uspomena, značka
Trim - podrezati, ošišati, podšišati, ugladiti, uravnotežiti, ukrasiti, ukrasi, karakter, drvenarija, doteran, kondicija, ugrađen, čvrst, u dobroj formi
Trout - pastrmka
Vain - sujetan, tašt,  uzaludan 
Valiant - imati ili pokazivati hrabrost, imati periku
Waterfront - priobalje
Whaler - kitolovac
Whim - ćef, kapric
Wicked - zao, poročan, rđav, nevaljao
Winch - čekrk
Wobble - klimati se, klatiti se, kolebati se
abashed - zbunjeno, stidljivo
abide - prebivati, trpeti, povinovati
abrupt - naglo, iznenada
ache - boleti, žudeti
acquiescence - pomirenje, 
admonition - ukor, savet, primedba
affront - uvreda
alder - joha
alien - vanzemaljac, stranac, stran, tuđi, dalek
almond - badem
aloof - dalek, rezervisan, povučen
amiably - ljubazno
amiss - pogrešno, nezgodno, u nevreme
ample - obiman
anguish - muka
annoyance - dosađivanje, muka
anoint  - pomazan, miropomazan
anxious - uznemiren, zabrinut
apprehensive - prestrašen, dovitljiv, oštrouman
arms - oružje, amblem
auburn - kestenjasta
aurochs - divlji vo
avarice-srebroljublje
avert - sprečiti, odvratiti, izbeći
awe - strahopoštovanje
axle - osovina
baffle - pregrada, žleb, zbuniti
bailey - spoljađnji zid od zamka
balding - proćelav
banter-šegačenje
barbed-bodljikav
bark - lavež, kora, koža
barley - ječam
barrack  - kasarna
barred-štraftast,zabranjen,zatvoren
barrow - humka, ručna kolica, uštrojen vepar
baseborn-niskog porekla
baste - prelivati, inf. isprebijati
bawdy - skaradan, odvratan, nepristojan
bay-zaliv,dorat,lavor,isturen prozor,tesnac,goniti,terati,lajati
beady - u obliku perle
bebe u utrobi
beet - repa, cvekla
befit - pristajati, lepo stajati, dolikovati
beget - roditi, stvoriti
behold - gledati
belch - podrigivati, izbaciti, izbljuvati
bend - družina, grupa, traka, vrpca, kolut, orkestar, vezati, obaviti, okružiti,
berate - grditi
bespeak  - govori, nagoveštava, poručuje
bestir-pokrenuti se, učinit napor,razmrdati se
betrothal - veridba
bicker - prepirati se
bide - čekati, ostati
bide-čekati,ostati
billowing  - talasati se
bit - komadić, trunka, glava svrdla, žvale
blade-sečivo,lopatica,list,energičan čovek
blaze - požar, plamen, planuti, buknuti
blazon - grb, opis grba, sjaj, pompa
blister - plih, mehur
blithe-bezbrižan
blob - grudvica, grumenčić
blot - mrlja, umrljati, upijati
blot out - izbrisati
blunt - tup, otvoren, iskren,nabusit, zatupiti
blurt - izvaliti, promrmljati
bluster - pretiti, hvalisati se
bodice - steznik, prsluk
bonfire - logorska vatra, lomača
born - nošen
bosom-grudi,nedra,bliskost
botch- loša zakrpa,loše uraditi zadatak
boulder-gromada,veliki kamen,oblutak
bound - vezan, granica, skok, graničiti se, iskočiti, suzbiti, spreman za pokret, koji kreće
bout - nastup, takmičenje
braid - pletenica, traka, vrpca, oplesti, oblagati
brandish-vitlati,mahati,pretiti
bravado - razmetanje hrabrošću
brazier - kazan, kotao, kazandžija
bridle-uzde,pokazivati prezir,zauzdati
brier - divlja ruža
brindle - braon/smeđe krzno životinje sa prugama neke druge boje
briskly - žustro
bristle - dlaka, čekinja, narogušiti se
brooch  - broš
brooding - izlegati, ležeći, zamišljenil
brook - potok, snositi, trpeti
brusque - grub, oštar
brute's - zver, životinja
burgundy - vino, bordo
burly - krupan, snažan
bustle - užurbanost, žuriti
buxom-punačka,jedra
cacked - stvrdnuti se
cairn-gomila kamenja za obelezavanje ili grobnicu
callus - kvrga, žulj
canopy - baldahin, nadstrešica
canter-laki galop
caparison - okititi konja
caper - skok, ludorija, ludirati se
capon-kastrirani pevac
caprice-hir,iznenadna nepredvidiva promena raspoloženja
careen- zaneti se,nagnuti broj
caress - milovanje
causeway - nasip, bedem
censer - kadionica
chafe - uzbuditi se , trljati
chagrin- žalost,razočaranost,poniženje
chamber pot - noćni sud
charred - ugljenisana
chasten-kazniti,obizdati,popraviti
chattel - pokretna imovina, lična imovina
chatter - cvoktati
checkerd - kariran, kockast
cheesemonger - trgovac mlečnim proizvodima
chink - uzak otvor ili pukotina, visok zvuk sudaranja čaša ili novčića
chip - žeton, iver, parče, odlomiti, seći
chivalrous - galantan, viteški
choicer - birani, bolje odabran
chuckle - prigušen smeh
chunk  - komad, debelo parče
circuit - strujno kolo, kružni put
clack - klaparanje
clad  - odeven
clammy - smolast, lepljiv
clamp - stezaljka, stega, spona, spajati
clangor - zvezkanje metala
clasp - kopča, šnala, stisak, obuhvatiti
clatter-zveket,bat,nered,tandrkanje
cleft-rascep,pukotina,rascepljen
clench - stisnuti, stegnuti
cloth - tkanina
clouded - zamagljeno, naoblačeno, zamračiti
clout-snaga,udarac
cloven - rascepljeno
cloying - prijatan, presititi
clump-grumen,grupa,topot teških koraka, teško koračati
cluster - grupa sličnih stvari
clutch - kvačilo, hvatati, ščepati
coarse - grub
cock - penis, petao, mužjak, naćuliti, podići
cocksure - arogantno siguran
cocky-drsko,arogantno
coffer - kofer, kasa
comb - češalj
composure - pribranost, staloženost
concession - ustupak, koncesija
confided - poveriti
confine-ograničiti,vezati,razgraničiti,staviti u priyvor,granica, međa
congeal - zgusnuti, smrznuti
conjecture - pretpostavka, nagađanje
consorted  - udruženi
contemplate - razmišljati, posmatrati
contempt - prezir
contrit - skrušen, koji se kaje
cooing - tepanje, gugutanje
coronet - venac, dijadema, tiara
couch - kauč, formulisati, spustiti
courtesies - ljubaznost učtivost
courtship-udvaranje
cowl - kaluder, kapuljača
crackle - pucketanje
crag - stena, greben, litica
cramping - grčiti se, sputati
craven - kukavica
crawl - puziti, mileti, vući
creak- škripa
crease- brazda,nabor,nagužvati,namrštiti se
creeping - puzanje
crept(creep) - mileti, puziti, odvratna osoba, izlaz
crescent - srp polumeseca, polumesec
crest - greben, grb
crevasse-pukotina( u glečeru)
crevice - pukotina
crib - krevetac, korpa, koš, jasle, prepisivati
crimson - grimizna, tamno crvena
crisp - hrskav, svež, jedar
croak-graknuti,kreštati,gunđati
crone - smežurana baba
crone-smežurana baba
crooked - kriv, nepošten, vijugast
cur - mešanac
curb - obuzdati, uzda, ivičnjak
curdle - zgrušati, usiriti
curled - sklupčati, kovrdžati
curt - kratak, odsečan
curtly - šturo
cutlery - escajg, pribor za jelo
dab - lak dodir, mrlja
dab-dodirnuti,potapšati,mrlja
dais - podijum
dais - podium
damnation - prokletstvo
damp - vlažan
dandle - ljuljati na rukama
dangle - visiti, klatiti
dank - vlažan, mokar
dapple - išarati
dash - crtica, povlaka, mala količina, nalet, juriš,  baciti, tresnuti, uništiti, poleteti
daybreak  - svitanje
daze - omamljenost, ošamućenost, omamiti
dazed - ošamućen
deem - smatrati, misliti
defile-uprljati,oskrnaviti,defilovati,tesnac,klisura
deft - vešt, spretan
deign - udostojiti
deities-božanstva
deliberate - nameran, razmišljati
demur - dvoumljenje, oklevanje, prigovaranje
dent - ulubiti
dent - ulubiti, ulublenje
derision - poruga, podsmeh
derisively - podrugljivo, prezrivo
destrier - konj srednjevekovnog viteza
devour - prožderati, gutati, slistiti
dirk - bodež, kama
disdainful - prezrivo
dismay  - užasnut
dismissive - odbacivanje, prezrivo
disquiet - uznemirenost, nemir
dissuade - odvratiti, odgovoriti
distaste - odvratnost, nenaklonost
dizzily - vrtoglavo
dodge - izvrdati, izbeći, smicalica, prevar
donned (don) - obukao, obući
dote - razmaziti, biti senilan
doublet - duplikat, srednjevekovna jakna
doze-lak san,dremanje
drab - siva, žućkastosmeđ, jednoličan
drafty - izložen promaji
drape - zavesa
dread - strah, užas
drear - dosadan, turoban
drifted out - odlutao
drifting  - strujanje
drill - bušilica, bušenje, vežbanje,trening
drip - kapanje, curenje, dosadna osoba
droll - zabavan, smešan, šaljivdžija, dvorska luda, šaliti se
droop - pognutost, srozati se, klonuti
droplets - kapljice
drowsy - pospan, mamuran
dull - dosadan, tup, glup, bezizrazan, suvoparan, zatupiti, ublažiti
duly- propisno, pravilno
dumb - glup, nem
dutiful-savestan,poslušan
dwindle - splasnuti, isčeznuti
eager - željan
earnest - kapara, depozit, ozbiljno
earnest - ozbiljno
ebbed -povlačiti se, opadati
ebony - crno drvo, abons
eel - jegulja
elk - los
elm - brest
emblazoned  - ukrašena
emerald - smaragd
enchanter - čarobnjak
engrossed - udubiti pažnju
enmity-neprijateljstvo
enrapture - zanos, razdraganost
errands - zadaci, poruke, porudžbine, poslovi
esteem - poštovanje
eunuch - evnuh
exasperated  - ogorčen, razdražen
excess - višak, neumerenost
exhilarate - razveseliti
exhilarated - raspoložen, veseo
exil - izgnanstvo, prognati, izgnanik
exquisite - izvrstan
eyrie - gnezdo ptice grabljivice
fabeld - dobrog kvalite
fable - basna,
faintly - slabo, jedva
fair - bela, lepa, poštena
famished-izgladneo
farce - farsa, lakrdija, šala
fastnes - postojanost, sigurnost, trajnost
fatiguing - zamorno
favor - naklonost, usluga, pokazati naklonost, čuvati
fealty - vernost
fearsome - strašno
featherbed - dušek od perja
feign - pretvarati se, simulirati
feral - podivljali, divlji
feroscious - svirep, izrazito nasilan
ferret-tvor,omčica
fervent - žarki, strasan
fervently - žarko
fervor-žar,zanos,vatrenost
festering - gnojiti se
festive - svečan, veseo
fetch - doneti, aportirati, nestašluk
fiddle - violina, svirati violinu
fiddled - vrckati, vrpoljiti
fidget - vrckati, uzvrpoljiti se
fierce - žestok, svirep
fig - šipak,smokva,pesnica
filigree - filigranski
filly - ždrebica, kobila
film - film, tanak sloj preko nečega
firepit - kamin
fishmaid - ribarica
fissure - pukotina, procep
flagon - boca
flail - mlatilica, mlatilo, mlatiti
flaky - ljuskav, čudan, pahuljast
flamboyant-kitnjast,previše ukrašen
flap - poklopac, zalistak, list, lepršanje, lepršati
flapped - lepršao
flaw-mana,pukotina,greška,nalet vetra
fleck - pega, mrlja, fleka
flick - iznenadan oštar pokret, zvrčka, lak udarac
flinch - ustuknuti,izbeći
fling - baciti, hitac, žurka
flint - kremen
flock - stado, jato, gomila, skupiti se
floppy - nemarni, viseći
flung - bacio
flurry - nalet
flush - rumenilo, zanos, svežina, tekuća voda, rumen, obilan, sprati, ushititi
fluttering- lepršati, viti
fodder - stočna hrana,
fold-smotati,saviti, nabor
fondle - milovati, maziti
footpad-uložak za cipelu
ford - plićak, prelaz preko plićaka
forearm - podlaktica
foreboding - slutnja, zloslutan
forestall-preduhitriti,sprečiti,zavladati
forfeit - gubiti, zalog, kazna, izgubiti pravo, konfiskovan
forfeit - zalog, kazna, izgubiti pravo
formidable-koji izaziva strah i poštovanje
fortnight - dve nedelje
foster  - gajiti
fragrance - miris, aroma
fragrant - mirišljava
frail - krhki, slab, nežan, neotporan
frailty - krhkost, slabost
frantic - mahnito
fray-iskrzati,napeti,pohabati,sukob,okršaj
freeriders - slobodni strelci
frequented-često posećivati
fret  - dirka, uzrujanost, uzrujati se
fringe-ivica,granica,resa,krilo,šiške na čelu
frolic - veselje, veseo, veseliti se
frostbite - promrzlina
frosted - pokriveno injem, pokriveno
fry - pržiti, mlada rib
fungus - gljiva
furrowed brow - nabrano čelo
furtively - krišom
gaffawed - vriskati
gag - geg, zapušiti
gait  - kas, hod
gale - oluja, bura, jak vetar, razdraganost
gall-žuč,čemer,bezobrazluk,ranjivo mesto,ogorčiti,iritirati
gallantry - galantnost, hrabrost,junaštvo
gape -zjapiti, zagledati, zevati, gledati ptvorenih usta, otvor
gargoyle - ukras sa grotesknim likom
garment - odevni predmet
garons - radnički konj
gash - duboko poseći, duboka rana
gasp - udahnuti naglo od uzbuđenja
gauge  - dleto, podvala, izdubiti
gaunt - mršav, koščat
gauntlets-rukavice, šiba
gaze - zuriti, zurenje
geld- uštrojiti,ušteojen konj
gemstone - dragi kamen
genial - genijalan, srdačan, blag
ghouls - zli duhovi
giddy - vrtoglavo, ošamućujuće
giggle - kikotati se, cerekati se
gilded - pozlaćeno
gimp-fizički hendikep za hodanje,silk
gingerly - oprezno,natenane
girth - obim, arh. okružiti
glare - blesak, santa leda, zveranje, blistati, zverati, sevati
gleaming - blistavo
gliding - klizeći, nečujno ići, jedriti
glimpsed - nazirati se
glint-sjaj,svetlucati
glittered  - blistati, sijati
gloom - mračan, sumornost
gloomy - sumoran, turoban, mračan
glower- mrštiti se,razrogačiti se,buljitu
glumly - mrzovoljno
glyphs - hijeroglifi
gnarled - kvrgavo
gorge - klisura, ždrelo, tesnac, grlo, gutati, nasititi, proždirati
gown - haljina
graceful - elegantan, graciozan
gracious - blažena, milostiva, elegantna
grape - grižde
grasp - shvatiti, uhvatiti, dokučiti, moć, ščepati
gravy - sos, soft
graze - ogrebati, pasti(travu)
grease - masnoća
greasy - masna
greaves-čvarci,oklop za cevanice
grim - mrgodan, strog, mračan
grimaced - napravio grimasu
grin - keziti, ceriti
grind - melevenje, samleti, smrviti
grinned - keziti se, ceriti se
grizzled - osedelo, sedo
groan - uzdisati, stenjati
groom - mladoženja, doterati se, konjušar, timariti
groom-konjušar, mladoženja
groped - pipati, tražiti, tumarati
growl- režati, krčati, promumlati
gruff - grub, osoran
gruff- grub, osoran
grumble - gunđati
grunt - roptati
gullet - guša, jednjak
gulp - progutati, gutati, žderati, gutljaj
hack- piskaralo,plaćenik, taksi, kljuse, pijuk, rešetkasto postolje, iseckati, tesati, udariti, kašljucati, komercijalan, najamni
hack-piskaralo,taksi,kljuse,pijuk,rešetkasto postolje,iseckati, tesati,udariti,kašljucati,komercijalan,najamni
hackles rise - kostrešiti se
haggard-unezveren,iscrpljen
hale - vitalan, čio, krepak, odvučen
halted - zaustavljen
hamlet-zaseok,seoce
hammering - zakucavanje
hamstring - onedposobiti, tetiva, tetiva kolena
handmaid - sluškinja
harness - upregnuti, viteška oprema, konjsks oprema, bojna oprema
harry-harati,pljačkati,kinjiti
harsh - grub
hatchling - mladunče iz jajeta
hatted - koji ima šešir na glavi
haul - vući, tegliti
haunches - bedro, lučni krak, zadnji deo
haze - izmaglica
hazy - maglovit
heap-gomila,hrpa,masa,mnoštvo,krntija,nagomilati,sipati
hearth - ognjište
hedge - živica, ograda, vrdati
hedgehog - jež, namćor
heed - oprez, pažnja
heft-tegliti,podizati,glavna stvar
hellbent - po svaku cenu
hemmed - oivičiti, porubiti, opšiti
hewn - tesan, klesan, sečen
hide - sakriti, koža, krzno
hideous - odvratan, gnusan, skaradan
hilt - drška
hint-nagoveštaj, mig
his - šištanje
hoarse - promukli
hobbled - sputati, hramati
holdfast - stega
hollow - udolina, šupljina
homely-domaćinski,porodičan,prost,ružan
hone - brusiti, oštriti
honk - gakati, trubiti
hoot - izviždati, bukati, krik sove
hovel - ćumez, udžerica
huddle - gomila, gungula, nabiti, skupiti se
huff - hvalisanje, ljutnja, huktanje
hulk - glomazan čovek, ponton, glomazan brod
hummock- humka, brežuljak
humor me - razveseliti me
hunched - poviti se
hunker-konzervativan,nazadan
hurtling - nekontrolisano padati ko bi
icicles - ledenice
ill at ease - nelagodno
imp - đavolak, vragolan
impervious - nepristupačan, nepropustiljiv
impetuous - nagao, plahovit
implacable - neumoljivo
inane-ništavan,prazan,glup
incense - tamjan, razjariti
incoherent - nepovezan
indisposed - neraspoložen, ne osećati se dobro
ineptitude - ne osećati se dobro
infestation - najezda (pacova, insekata)
inn - gostionica, krčma, restoran
insipid - neukusan, bljutav
insofar - utoliko što
insolent - drzak, bezobrazan
instep - gornji deo stopala
intricately - komplikovano, zamršeno
ivy  - bršljan
jagged - nazubljen, 
javelin - koplje
jerk - trzati, trgnuti, glupan, glup
jerkin-kožuh,koporan
jest - sala, dosetka
jiggle - drmusati se, tresti
jolt-trzaj,uzdrmati,protresti,udariti
jostle - guranje, laktanje
joust - viteška borba ili takmičenje
jowl-obraz,podvaljak,vilica,čeljust
jowls - čeljusti
jug - bokal, krčag,slavujeva pesma, zatvor
juggle - žonglirati, manipulisati
jumble - zbrka, mešavina
jut - štrčati,izbočina,isturiti deo tela
keen - oštar, žudan, željan, oduševljen, pronicljiv
keening - žalosno zavijanje
keg - bure, burence
kennel - štenara, odgajivačnica, kućica za psa, oluk, slivnik
kindle - zapaliti, osvetliti
kindling - raspaljivanje, drvo za potpalu
knuckle - zglob, čukalj,kolence
kombinezon, parče, pristanište, sadnica, klizanje
kraken - mitsko čudovište nalik na hobotnicu
laborious - naporan, mučan, težak
ladle - kutlača
lance - probosti, provaliti, koplje
languidly - mlitavo
langurous -labav,malaksao,klonuo
lank - dug, suv
lantern - fenjer
lap - krilo, krug
latch - reza
lavish - raskošan, izdašan, preobilan
lay -svetovni,nestručan,položiti,staviti,urediti,prostreti,balada,karakter,snošaj,ljubavnica,
lean - mršav,suvonjav
leap - skok
lecherous - pohotan, razvratan
ledge - izbočina, obod, ležište, sloj
leggings- helanke, dokolenice, hulahopke
lid - poklopac, kapak
lidded - koji je sa poklopcem
liege - vazalni gospodar
liking - sklonost, volja, dopadanja
lilac - lila,boje jorgovana, jorgovan
lilt - raspevan, pesma
limb  - ud, grana
limp - opušten, labav, hramati, šepati
lineages - rod, loza, soj
linger - razvlačiti se, ležati na samrti, otezati
lists - liste, arena
lithe-gibak,savitljiv
litter - leglo, prostirka
livery - specijalna uniforma za sluge
loathing - sa gađenjem, sa gnušanjem
lock - brava, pramen, kočnica, brana, lokna
lodge - uložiti, zastati, smestiti, loža, kućica, koliba
lofty - uzvišen, blagorodan
loins - slabine
longing - vapaj, žudnja, čežnja
looming - nazirati se, promaljati, nadvijati
lordlings - gospoda
lurch - zateturati, trzaj, naglo skretanje
lurk - čekati u zasedi, skrivati se, vrebati
lusterless - bez sjaja
mace-buzdovan,topuz,žezlo
magots  - crvi
maidenhead-devičanstvo,himen,nevinost
mail - pošta, pisma, oklop pancir, pošiljka
maim - osakatiti, sakatost
mane - griva, gusta kosa
manly - muški, muževan, junački
manner-manir,držanje,ponašanje,vrsta,
manse - sveštenička kuća, kuća od zemlje 
manticores - mitski biće(lice coveka,telo lava,rep škorpiona)
mare - kobila, more
marshal - maršal, dovesti u red, organizovati, prikupiti
matted - matiran, mutan
maul- malj, teško povrediti
meager - oskudno
meandering - krivudanje
meddling-mešati,nameštati
meekly - krotko
meekly - pitomo, krotko
melee - gužva, borba prsa u prsa
mellow -mek, blag, zreo, sočan, pripit,
melon - dinja
menagerie - menažerija, zverinjak
mere - puki, sam, čist, jedva
midden - đubrište
midden- đubrište,bunjište
mild - blag, nežan
mingled - pomešani
mirth - veselje, razdraganost
mischief - nevolja, pakost, šteta
misshapen - nakazan, ružan, deformisan
mist - izmaglica, maglovitost, zamagliti, magliti se
moan - oplakivati, tugovati, jecati
molder - modelar, radpadati se, truliti
moleskin - krtičije krzno
molten  - rastopljeno
mongrel - mešanac, melez, polutan
morsel - komadić, zalogaj
mortar - minobacač, malter
mortify-mučiti,poniziti
moss - mahovina
motley - šarenilo, šareno odelo dvorskih budala
mouthed-izustiti
mouthful - zalogaj
mucking - đubrenje
muffle - ugušiti, prigušiti, umotati
muffled - prigušen
mulled - kuvati i začiniti, pobrkati,zabrljati
mulled wine - kuvano vino, zabrljati
mummer  - pantomimičar
murmur - mrmljati, žuboriti, žagor
muse - muza, nadahnuće, razmišljati, sanjariti
muse - razmišljati, sanjariti
musing - razmišljanje
muster - prikupiti, prozivka, zbor, foirste
musty - buđav,bajat, ustajao
muttered - promrmljati
mutton - ovčetina, ovčiji
neigh - njištati, rzati, vikati
nibble - grickati, glodati
niche - niša, kutak, mesto, utočište
nicked - urezati,zarezati
nigh - blizu, skoro
nightingale - slavuj
nimble - okretan, bistar, spretan
nimble- okretan, bistar, spretan
nip - mraz, gutljaj, štipanje, otkinuti
nip-mraz,gutljaj,štipanje,otkinuti,ugišiti,ukleštiti,štipnuti
notion - predstava, utisak, misao, pojam
nought - ništa, bezvredan, nula, gotovo ništa
numb - utrnuo, ukočen, otupeo
nuzzled - priljubiti se, trljati nosem
oaf - tikvan, derište, gluo nekulturan u nespretan
oblivious - nesvestan
obsidian-vulkansko staklo
omen - znak, predznak, znamenje, predskazanje
onyx - oniks
opressive,- tiranski,surov,ugnjetavajući,
orchard-voćnjaj
ordeal - iskušenje, nepriajtno iskustvo
ornate - ukrašen, kitnjast
outflung - odbačen
outline - ocrtati
outrage - zgražavanje,sramota,uvreda,silovanje,
outstreched - ispružen, opružen
overcast - oblačan, natmuren, pokriti
overhead - vazdušni, opšti, gornji, nadzemni
pad - uložak, podloga, jastučić, hodati 
palanquin - nosiljka
pallid - bled
palpably -opipljivo
pampered - razmaženo, nakljukano
pane - okno
panting - dahtati
paragon - uzor
parapets - ogradni zidovi na mostu/tvrdavi
parchment - pergament
parry - odbijanje
pastries - peciva, kolači
pat - zgodan, podesan, potapšati, komadić
pawing - dodirivati šapom, udarati,nezgrapno pipati
peas in a pod - jaje jajetu - ličiti
pebble-šljunak,oblutak,gorski kristal,bacati kamenje,hrapaviti kožu
peck - zobati, kljucati
peck - zobati, kvocati,kljucati, poljubiti, jedinica za merenje žita
peer - viriti, piljiti, premac, rival, vršnjak, saradnik
peerless - bez premca
peg - klin, kočič, zub, noga, ključ za zatezanje žica, baciti, odrediti, spojiti klinom
pen-olovka,pisac,tor,kokošinjac,labudica,zatvoriti u tor,pisati
penance - epitimija, ispaštanje
pendant - privezak, visuljak
perch - motka, grana, grgeč, smuđ
perfunctory - površan
perilous - opasan
persimons - slatko voće koje liči na paradajz
petals - latice
petulant - mrzovoljan
petulant-mrzovoljan
pewtar - kalaj
phlegm - sluz
pier - pristanište, stub
pimple - bubuljica
pin - igla, čioda, špenadla, zakačiti, pribosti
pinch - štipnuti, pritegnuti
pitcher - bacač, bokal, krčag
pitied - sažaljevao
placid - miran, tih, spokojan
placidly-smireno
plank - daska
pledge - zalog, zavet, znak ,obećanje
plinth-postolje
pluck - hrabrost, drob, očerupati, otkinuti
plum - šljiva, crveno purpurna boja
plume - perjanica, pero
plume-pero,perjanica,imati perje
plump - debeo, jedar, punačak, iznenadan/težak pad
plunder - otimačina, pljačkati
plunge - gnjuranje,zaroniti,skočiti,strmoglaviti
poacher - lovokradica
pock - boginja
pointy - šiljati
poise-staložen,lebdeti,uravnotežiti
poking-bockanje,udariti,probiti
pole - motka, stub
polished - uglačani
pomegranate - šipak, nar
ponderous - težak, masivan
portcullis - rešetke
portly-naočit
posked - osuto
post - mesto, pošta, stub, dužnost, garnizon, vesnik, direk, postaviti, poslati poštom, istaći, prilepiti, proglasiti, stacionirati, uknjižiti
postaviti, tapacirati, povećati
postern - zadnji/sporedni ulaz
pot - lonac,kotao, šerpa
potion - napitak
pottery - grnčarija, posuđe
poty - naduren
pout - duriti se
prattle - brbljati, razglabati
precipitous-strm,nagao, preran
prickle - bodljikavo
pristajanje,pokoravanje
professing - predavati, izjaviti, izjasniti
promintory - rt, ispupčenje
prospect - izgled, kandidat, istraživati, kopati, pregledati
prospect-mogućnost budućeg dogadaja
provided-obezbeđeno,pod pretpostavkom,ako
provision-odredba,zaliha,snadbevanje,obezbeđivanje
prowl - krstariti, tumarati
pry - zagledati, dizati polugom
puff - pućkati, dahtati, dah, naduvati
puffy-podbuo,vazdušast
pupil - zenica, učenik
purging - pročišćavanje
puzzled - zbunjen, smeten
quail- prepelica,klonuti,obeshrabriti se
qualm-muka,zlo,sumnja
quaver - osmina, podrhtavanje
queasy - uznemiren, gadljiv, mučan,osetljiv
queer - čudan, izopačen
quench - ugasiti, utoliti
quicken - ubrzanje, oživeti, osećaj pokreta 
quicksand - živi pesak
quipped - našaliti se
quiver-drhtati,treperiti,kutija za strele
quivering - drhtati
rabble-ološ,rulja,mešalica
radiant - ozarena, zračeći
rafter - splavar, krovna greda
ragged - odrpana
rake-zasuti vatrom,zaraditi,skupiti,grabuljati,grabulje
ramp - rampa, platforma, strma ravan, ulaz/izlaz autoputa, propeti se
rampart - bedem
rank-rang,čin,vrsta,špalir,plodan,sušiti,čisti,bujan,neprijatan
rash-plah,hitar,osip,izbijanje
rasher - ražanj
rasping- strugati, škripati, hrapav
ratter - mišolovka
raucous - hrapav
raucous - promukao, hrapav, grub
raw - sirov, izranjavan, ojeden
reared  - podizati se, propeti se(konj)
receded - povučen, odstupao, opadao
recline - zavaliti se, popraviti 
reconcile - pomiriti
reddening  - crveneti
reed - trska
reed - trska, duvački instrument,osoba slabog karaktera
regal  - kraljevski
reins- uzde
relent - popustiti
relentless - neumorno, nepopustljivo, uporno, nemilosrdno
relieve - olakšati,vršiti nuždu,smeniti, izbaviti, oslabiti
relish - slast, ukus, naslađivati se
remark - napomena, primedba, opažanje
remnant - ostatak, zaostatak
rendering - vraćanje, malterisanje, polaganje, prevođenje, predstavlja
replenish - dopuniti, napuniti, ispuniti
reproach - ukor, prekor, zamerka, prigovor
resentment - ozlojeđenost
resigned- pomiren sa sudbinom, rezigniran
resolute - rešen, odlučan
resounding-veliki,koji odjekuje
restive-nemirni
restrained - uzdržan
retainer - pratilac, držač
retainers - držači
retinue - svita, pratnjan
retribution - odmazda, kazn
revels - pijančiti,pir
reverse - preokrenuti, obrnuti, ukinuti, menjati pravac, obrnut, suprotan, negativan, suprotnost, zla sreća, naličije, pora
rheumy - reuma, vodene oči
rickety-klimav,raskliman
ringmail - oklop od prstenova
ripe - zreo, sazreo, puštena mina
ripping - izvrsno
rippling - talasasti, namreškani
rise to the bait - upecati se
rivulet-potočić
roam - lutati, tumarati
roil - zamutiti
rookery - gnezdo vrane
rubies - rubini, bubuljice
rudiments - osnove,začeci
rue - žaliti, ruta
rueful - žalosan, tužan
ruffle - nabirati, narogušiti, talasati
rugged - neravan, hrapav, buran
rumble - tutnjava, krčanje, tuča
rumble - tutnjava, tuča, gruvanje, krčati, razleći,
rumination - razmišljanje, žvakanje
rump - ostatak, kuk, zadnjica
rush - nalet, žurba, rogoz, hitati
rustle - šuškati
sable - crno, samurovina, samur
sachet-kesica sa mirišljavim prahom
sag - ulegnuće
sag-ulegnuće,potonuće
salvage - spasiti, spasavanje, trofej
salve - melem, lečiti melemom, otkloniti
sap - biljni sok
sardonic - podrugljiv, zloban
sate - zasititi
saunter - gegati, tumarati, šetnja
savory - ukusan, pikantan, mirisan
scabbard -  korice
scalding - vrelo
scale - skala, brojni sistem, lestvica, krljušt, ljuska, odrediti merilo, perutati se, popeti se, savladati
scalp - skalp, lobanja, skalpirati
scant - oskudan, nedovoljan, neadekvatan
scarce - slabo, jedva
scarlet - skerlet, grimizan, ljubičasto crven, kurvinski
scattering - rasipati se
scheme- šema, praviti planove
scold - grditi
scone - tanak, glava, pljosnat kolač
scoop - kugla, kašika,zahvatiti, zgrabiti
scour - ribati, čistiti, pretraživati
scowl - mrštiti se
scrabble-škrabati,grebati
scramble - verati se, na brzinu sastaviti, žurba
scrape-škripac,ogrebotina,tuča,strugati,životariti,ogrebati,provući se
scrawny - mršav, koščat
screen - ekran, sito, paravan, zakloniti, proveriti
scrubbed - ribala
scrypt-pisana slova,rukopis
scuff -gebati, trag, vući noge, izbubetati
scuffling-tuča,šuštanje
scythe - kosa,pokositi
sear - spržiti, žigosati, sagoreti
sear - spržiti, žigosati, sagoreti, učiniti neosetljivim, osušenost, suvoća
seep - curiti
seeth - kipet, ključati
seldom - retko
sentinel - stražar
sentry - stražar
sept - bratstvo
sepulchers - grobnica, mauzolej
severe-težak,strog, žestok ozbiljan
severed -odsečen
shaft - osovina, okno, ruda, vratilo
shaggy - čupav
shard - krhotina
shear -ošisati
sheen - sjaj
sheepishly - stidljivo
shimmer - svetlucati
shin-cevanica,uzverati se
shiver - drhtati, cvoktati, odlomak, parče, jeza
shock-iznenadni udar,potres,čupa,gomila nekoliko snopova,rundov, čuperak,
shod-obuti,potkovati,potkovana
shook - tresao
shorn-ošišan,lišen,ogoljen
shouldered - napraviti obod, progurati se, staviti na rame
shove - gurnuti, guranje
shovel - lopata, ašov, lopatat
shrieking - vrišteći
shrilly  - kreštavo, kreštati
shrouded - obavijen velom, zaodenut, umotan
shrugged - slegnuti ramenima
shrunken- smežuran, skupljen
shuder - drhtati
shun - izbegavati
shutter - zatvarač, kapak, poklopac, blagajničko prozorče
sickening  - mučan, odvratan
sigil - simbol, znak, logo
sill - prag
sill-prag
simpleton - prostak, glupan
sinister - zlokobno, na levoj strani
sip - srkati, pijuckati, gutljaj
sire - okotiti, životinja kad rodi
sizzle - cvrčati
skewer - ražanj, nataknuti na ražanj
skirt - suknja, obilaziti
slab - ploča, kaljuga
slam - zalupiti, tresak, pobeda
slash  - sekući udarac
slattern - aljkava žena
slender - vitak
slick - klizav 
slid - skliznuti
slink off - odšunjati se, odlunjati se
slip - skliznuti, klizati,zaneti, navući, izbrbljati, tutnuti,omaška, komad
slipper - papuča, ogrtač
slit - prorezati, rascepiti
slither - kliziti
slitted - prozračne
slope - nageti se
slouch - nemarno držanje tela, tromo se vući
slough - odbaciti(kožu), odstraniti, močvara
sluice - vrata na brani, ustavljena voda, odvod, pranje, potapanje
slumped  -  klonuti
slunt - nagib, kos, iskošen
slurred - nerazgovetan, nejasan
smirk - zlobno se smeškati
smoky - dimljeni
snags - prepreka, čvor, kvrga
snap - talas, kopča, puckanje, hvatanje, naglo pomeriti, odbrusiti, odskočiti, pokušati ugristi, pući, fotografisati, ščepati, škljocnuti, prenagljen
snark - životinja iz bajke
snarling - režati
snatched - zgrabiti
sneak - prikradati se, šunjati se, šunjalo
sneer - podrugljivo se smeškati
snick -zasek,narez,okrznuće,zaseći
snigger  - smeškati se
snoring - hrkanje
snorts - šmrkati, frktati
snuff - burmut, ugasiti, zažaren fitilj na sveći, ušmrkati, onjušiti
snug - udoban, prikladan
snuggled - ušuškati se
sodden-raskvašen,natopljen
solace - uteha
solemnly - svečano
solicit - tražit
solicitude - brižnost
solitude - samoća
soot - čađ,garež
sore - rana, bolan
sour  - kiselo, namćorast
southron - južnjak
sow - krmača, sejati
spade - ašov, pik lopata, uškopljena životinja, kopati ašovom
spare - rezervni, slobodan, oskudan, izlišan, redak, suvišan, suvonjav, poštedeti, žaliti, štedeti, odvojiti
spare-rezervni,suvišan,oskudan,slobodan,redak,suvobjav,poštedeti,žaliti,odvojiti,rezervni deo
spasmed - grčevito
spat - pljunuti (perf), svađa,ćuška svađati
spawn - mrest, ikra, mlađ
speckle-bobica,mrljica,prošarati mrljama
spire-spirala,zavojnica,vrh tornja,šiljata kula
spit - pljuvanje, ražanj
splash-zapljuskivati,prskati,mrlja,vodena prašina
splendor - raskoš, sjaj, divota
splintered - rascepljen, razbijen
splinters - krhotina, iverica, parče granate, cepanica, razbiti se, rascepiti
splotch - mrlja, umrljati
spoor-trag životinje
sprain - uganuće, iščašenje
sprain - uganuće, iščašenje
sprawl  - opružiti, širiti
spring-proleće,feder,izvor, skok,aktivirati,iskriviti,skočiti,izdejstvovati
sprinkle - posuti, prskati, kišica
sprout-nicati,izbijati,niknuti,nabujati,zaperak,mladica
spruce-omorika,smreka,doteran,nalickan
spun gold - zlatan konac
spur - mamuza,ogranak,podsticaj,podupirač
spurred  - podstakao
squabble - svađa, prepirka
square - kvadrat,trg,kruta odoba,kvit, pošten,vezana vreća, uglast,pošteno, ispravno,podmiriti,prilagoditi,kvadritati,učiniti četvrtastim,biti u skladu
squeal - vriska ,cika
squint-škiljiti,žmirkati,razrokost,zrikav
squirmed  - migoljio se
stag - muškarac bez žene, jelen, uštrojena zivotinja
staggering - kolibljivo, posrtati, koji zapanjuje
stalk - struk, stabljika, loviti pretraživanjem
stall - pregrada, staja, mesto, gubitak brzine
stamp feet-  lupati nogom
startle - iznenaditi, zaprepastiti
staunch-čvrst,odan,veran
stench - smrad
stern - krma, strog, surov, ozbiljan
steward - upravnik, nadzornik, brodski konobar
stiffly - ukočeno
stillbirth - mrtvorođeno
stirred - komešati, micati 
stirrup - uzengija
stlt - štule, štake
stock - akcija,zaliha,stoka,skladište,poreklo,soj,nečija specijalnost,nagomilati,snadbeti,
stocky-zdepast
stolid-čvrst,tup,neosetljiv
stoop-pognuti,saviti,pognutost,stepenice,saginjanje
stopper - čep, pampur
stout - jak i krupne građe
strand - nit,nasukati, ostaviti na cedilu,struka, obala
strands - pramenovi
strap-kaiš,remen,bretela,travni zalistak,privezati kaišem,tući kaišem
streak - pruga, kukavičluk, žičica, crtica, trag, praviti pruge, projuriti
streak - pruga, kukavičluk, žičica, trag, crtica, praviti pruge, projuriti
stride - dugačak korak, napredovanje,konjski hod, koračati
striking - upečatljiv,upadljiv,napadanje, udaranje,štrajkovanje
stroll - šetnja
struck - udariti, otkucati, zauzeti,zveknuti, izbiti, izbrisati, naići, naneti, odalamiti, odzvoniti, odrapiti, strefiti, štrajkovati
struddle - opkoračiti, urakljiti
stubble - stabljike posečene pšenice, brada nebrijana nekoliko dana
stucco - gipsani malter
stuff - stvari, građa, otpaci, tkanina, materijal, napuniti, ispuniti, preparirati, nagruvati, nadenuti, natrpati, nabijati, nakljukati,
stuffy - zagušljivo, zapušeno, sparno, uštogljeno
stumble - posrnuti, spotaći, zapeti
stumps  - panjevi, patrljak, mesto
stung - ožariti, ubosti, peći
stunt - štos, podvig, učiniti kržljavim, sprečiti rast
sturdy - čvrst
styling - oblikovati, nazivati
submerge - zaroniti, potopiti
submission - pokorenje, potčinjenost, pristajanje
subterranean - podzemni
succor-pomoć,pojačanje,pomoći
succulent - sočan
sulk - pućiti se, duriti se
sullen - smrknut
sullied - ulrljan, ukaljan
sully - prljati, kaljati
summit - vrh, samitl
supple - gibak, fleksibilan, mekano
surcoat - ogrtač
surmise - nagađanje, pretpostavka
swarm - vrveti, rojiti se, gomila, jato
swat - ucmekati, spljeskati
swatch - uzorak, mustra, patern
sway - zastraniti, uticati, njihati, lelujati
sweltered - sparen, preznojavati se
swindle - varati, prevara
swirling - vitlati, kowitlati
switl - vrtlog, kovitlanje
swung - zamahnuo, vitlao
tactful - taktičan, imati takta
taint - pokvariti, umrljati, ljaga, mrlja
tally- oznaka,značka,evidencija,podudarati se,staviti značku
tangle up - zapetljati
tapestry - tapiserija
tatter - otrcana, dronjci
tavern - kafana, pivnica
temper - ublažiti, kaliti, očeličiti, volja, temperament
temper - ublažiti, kaliti, očeličiti, ćud, plahovita narav, čvrstoća, raspolozenje,volja
tender - ponuda, matični brod, nežan, mek, blag
tenderness - nežnost, mekoća, saosećajnost
tending - čuvanje, negovanje, staranje, naginjanje
thaw - raskraviti, rastopiti
thicket   - čestar
thimble - naprstak, karika
thrice - triput, temeljno
throb - lupati, udarati, pulsirati
throttle - gušiti, regulisati, ventil za dovod goriva
thrust - potisak, napad, ubod, udar, guranje, tendencija, gurati, gurnuti, zabosti, zariti, probosti
thud - tup udarac
thumping  - lupati
thunderclap-udar groma
thunk-tup zvuk posle udarca,udarac,p.p.think
tidings - vesti, informacije
tilt - nagib, platneni krov, prepirka, megdan kopljima, nagnuti, iskositi, napasti
timorously - bojažljivo
tine - zubac, krak
tines - zupci
tinge-primesa,trag,nijansirati,obojiti
tingle - trnci, peckati, štipati
tinkle - zvoniti, urinirati
tiresome - dosadan, nezanimljiv
to plague - zaraziti se, mučiti, kinjiti
toll- dažbina, taksa, danak, mleti
topple - srušiti, oboriti, svaliti
torment - muka,agonija
torrent-voddoderina,bujica 
tossed  - bacio
tourney - turnir
tractable-povodljiv,poslušan,pokoran
trail - staza, vući
train - voz, komora, pratnja
transfixed - probola
translucent  - providan
treacherous - izdajnički, podmukao, opasan
trek - seoba, teško putovanje
trembled - drhtao
tremulous-treperav,lepršav,plašljiv,drhtav
trencher - rovokopač, hrana, daska za sečenje
trepidation - strepnja, strah
trestle - skela, nogari, potpora
trickle - curiti, kapljati
trickle-curiti
trickster - varalica
trifle-sitnics,smejurija,bagatela,ludirati se,šaliti se
trifling - sitnica, beznačajno
trim - podrezati, ukrasiti, podšišati, dovesti u red, karakter, drvenarija, kondicija, doteran, čvrst, u dobroj kondiciji
trip - put, tura, greška, saplitanje, halucinacij, saplesti, aktivirati, prekinuti struju
trip up - sapleti
trot - kas
trunk - stablo, sanduk, gepek, trup
tub - kada, kaca, spor brod/čamac, kupanje u kadi
tuck - ugurati, uvući, sačuvati, šav
tuft - čuperak,resa,ćuba
tugged - tegliti, vući
tumble - nered, pad, rasulo, srušiti, nabasati, shvatiti
tumbledown - srušiti se, trošan
tumult - verva, metež, graja, uzburkati
tumultuous - buran
tune - podesiti, naštimovati, sloga, melodija
twang-oštar, zvonak zvuk,zvučati kao žice
twich - trzaj, čupati, grčiti se, igrati, kidati,brnjic
twilit - sumrak
twining - upleteni
twining- viti, uplesti
twinkling -treperenje, trenutak, svetlucanje
twitch-trzaj,čupati,grčiti,igrati,kidati,brnjica
unbidden - nepozvan, spontan
unctuous -blag,zanosan,mastan,ublažujući,uljast
undergrowth  - žbunje, rastinje
unease- nelagoda
ungainly - nezgrapan, nespretan, neunosan
unison - jednoglasje, sklad, saglasje
unkempt-razbarušen,neuredan,aljkav
unmanned - bez posade
unruly - neposlušan, nestašan, neuredan
unsettling - uznemiravajući
unsullied - neokaljan
unto - do, prema, ka, u, na, za
unyealding - nepopustljiv, nesavitljiv
upend - prevrnuti, oboriti
uproar -galama, metež, buka, uzbuna
uproariously - bučno
urge - nagon, težnja, poriv, podsticati
usher - vratar, (onaj koji uvodi goste)
utter - izjaviti, izustiti, potpun
utterly - sasvim, potpuno
vacant - prazan, upražnjen
vagabond - skitnica, baraba, protuva
valiant - hrabar
vangeful - osvetničke, osvetoljubive
vanquish - pobediti
vantage point - povoljno mesto/prilika
vault - svod, luk, grobnica, skočiti, preskočiti
veer - menjati pravac, skretati
velvet - somot
venison - srnetina, divljač
verdant - zelen, nezreo
veritable - istinski
vest - prsluk, odora, dati, dodeliti
vex - dosaditi, pretresati, nasekirat, uznemiriti
vigil - bdenje, budnost
vigil - bdenje, budnost
vigorous-snažan,energičan
vile - odvratan, podao, zao
vista-vidik,pogled,perpektiva,niz uspomena
volumneous - obiman
vouch - jamčiti, svedočiti, tvrditi
waddl - gegati
wager - opklada, ulog, gegati
wailing - lelek, jadikovanje, naricanje
ward  - štićenik, čuvar
wardrobe - garderoba
wares-roba
warren - zečije jazbine, zečije odgajivačnice
wary - oprezan
wasting - rasipajući
watchful - budan, na oprezu, gledanje
wax - vosak, voskirati, rasti, puniti se
weakling - slabić
wean- odviknuti,odbiti dojku,odučiti
weariness - umor, iznurenost
weary - umoran, iscrpljen
weather-vreme, vremenski,izdržati,prebroditi,izložiti se uticaju vremena
weathered-istrošen
weave, wove - tkati, tkao
wed - oženiti se, udati se
weeping - plačući, kišovito
welled - izbijati u mlazu
welt - masnica, modrica
wench - devojka
whack - udariti, udarac
whedge - klin
wheedle - izmamiti, iskamčiti
wheeling - obrtanje, vožnja, kružiti nebom
whelp - ošteniti se, mladunče
whetstone - tocilo, brus
whimper - cvileti
whimpery - cvileći
whindpipe - gušnik
whinny - rzati, njištati, cviliti
whirl - kovitlati, obrtati se
whisker - brkovi, dlaka
whit - mrvica, trunka, čestica
whoop - poklič, vika, uzvik
wick - fitilj
wield - rukovati,držati, posedovati
wiggle-mrdati,vrckati,koprcati,praćakati,meškoljiti,migoljiti
wildlings - divljacia
wince - trzaj, trgnuti se, brecnuti se
wind - vetar, namotaj, namotati, vijugav
winding - krivudav, vijugav, spiralan
windmiling - vetrenjača, vrteti rukama
wiry-žilav,čvrst,sličan žici
wisps - pramen, sugestija, nešto tanko
wistful - setno, zamišljeno
wit - razum, um, smisao za humor
without - bez, napolju
wits - pameti
worship - obožavanje, bogosluženje
wreathe - venac, uplesti, okružiti, pokriti
wrench - bol, uganuće, iščašenje, ključ, trzaj
wretch  - bednik, paćenik, jadnik
wriggle - izvijati, vrdati, vrteti
wrinkle - bora, nabor, gužvati se, mrgoditi, smežutati
writ - sudski nalog, pismeno
writh- uvijati se,grčiti se
wrought - kovan, rađen
wry - uvrnut
yank - vući, trzaj ,1 trgnuti
yawn - zevanje
yearn - čeznuti, žudeti
yelp - zacvileti,  siktati, kevkati
yield - prinos, rod, popuštanje, pokoriti se